1111111111111111111111111111111111
100000000000000C00000100000000E001
1001010100100000101001000000010101
1001010010100010001000000000010101
1P0000000C01C1000000010000000000C1
1111111111111111111111111111111111