1111111111111111111111111111111111
100000000000000C00000100000001E101
1001010100100000101001000000010011
1101010010100010001000000000010101
1P000000C01C1000000010000000000C11
1111111111111111111111111111111111